Dd, Dd, Dd, Dd, Dd, Dd, Dd, Dd, Dd, Dd^Edpp, Dd, Dd, Rd, Dd^Do, Dd^Esd, Dd^Edp, Dd, Dd, Dd, Dd, Dd, Dd, Dd, Dd, Dd, Dd, Dd, Dd, Dd, Dd^Edb, Dd, Dd^Edb, Dd, Dd, Dd, Dd, Dd, Dd, Dd^Esd, Dd, Hd, Hd, Hd, Dd, Hd, Dd, Dd, Dd, Dd, Dd^Edp, Dd^Dc, Dd, Dd^Edp, Dd, Dd, Dd, Dd, Dd, Dd^Esd, Dd^Esd, Dd
Dd, Dd, Dd, Dd, Dd, Dd, Dd, Dd, Dd, Dd, Dd, Dd, Rd, Dd, Dd, Dd, Dd, Dd, Dd, Dd, Dd^Edb, Dd, Dd^Edp, Dd, Hd, Dd, Dd^Esd, Dd, Dd, Dd, Dd^Edpp, Dd, Dd, Dd, Dd, Dd, Dd, Dd^Edp, Dd^Edpp, Dd, Dd, Hd, Hd, Hd, Hd, Hd, Dd, Dd, Dd, Dd^Edp, Dd, Dd, Hd, Dd, Dd, Dd, Dd, Dd, Dd, Dd, Dd
Dd, Dd, Dd, Dd^Edpp, Dd^Edp, Dd, Dd, Dd, Dd, Dd, Dd, Dd, Rd, Dd, Dd, Dd^Esd, Hd, Hd, Hd, Hd, Dd, Dd, Dd, Dd, Hd, Dd, Hd, Dd, Dd, Dd, Dd, Dd, Dd^Vdt, Hd, Hd, Hd, Hd, Dd, Hd, Hd, Rb, Dd, Hd, Hd, Hd, Hd, Hd, Dd^Esd, Dd^Esd, Dd, Dd, Dd^Edpp, Dd, Hd, Hd, Hd, Dd, Dd^Edpp, Dd^Esd, Dd, Dd
Dd, Dd, Dd, Dd, Dd, Dd, Dd, Dd, Dd, Dd, Dd, Rd, Dd, Dd, Dd, Dd, Hd, Hd, Hd, Dd^Esd, Hd, Dd, Dd, Hd, Hd, Hd, Hd, Dd, Dd, Dd, Dd, Dd, Dd, Hd, Hd, Hd, Hd, Hd, Re^Edb, Hd, Rb, Re, Dd, Hd, Hd, Dd, Dd, Dd^Vdt, Dd, Dd, Dd, Hd, Hd, Hd, Hd, Dd^Esd, Dd, Dd, Dd^Esd, Dd^Edb, Dd
Dd^Edb, Dd, Dd, Dd, Dd^Vdt, Dd, Dd^Edpp, Dd, Dd, Dd, Dd, Rd, Dd, Dd, Dd, Dd, Hd, Hd, Dd^Vdt, Hd, Dd, Dd^Esd, Dd^Edb, Dd, Dd, Hd, Hd, Hd, Hd, Dd, Dd, Dd, Dd, Dd, Hd, Hd, Dd, Dd^Edb, Rb^Edb, Rb, Cer, Re, Rb, Hd, Hd, Hd, Dd, Dd, Dd^Edp, Dd^Edb, Dd, Dd^Edp, Hd, Hd, Cdr, Hd, Dd, Dd, Dd, Dd^Es, Dd
Dd, Dd, Dd, Dd, Dd, Dd, Dd, Dd, Dd, Dd^Ftd, Dd, Rd, Rd, Dd, Dd^Edb, Dd, Dd, Dd^Esd, Dd, Hd, Dd, Dd^Esd, Dd, Dd^Esd, Dd, Dd, Hd, Hd, Hd, Dd, Dd^Edp, Dd, Dd, Dd^Edp, Hd, Hd, Hd, Dd, Rb, Cer, 4 Ker, Cer, Rb^Edb, Dd^Edb, Dd^Esd, Dd, Dd, Dd, Dd, Dd^Esd, Dd, Dd, Dd, Hd, Dd, Dd, Dd, Dd^Edb, Dd, Dd, Dd
Dd, Dd, Dd, Dd, Dd, Dd, Dd, Dd, Dd, Dd, Dd^Esd, Dd, Rd, Dd, Dd^Edp, Dd, Dd, Dd, Dd^Edp, Dd, Dd^Es, Dd, Dd^Esd, Dd, Dd, Dd^Ftd, Dd, Hd, Hd, Dd, Dd, Dd, Dd, Dd, Dd, Dd^Ftd, Dd, Dd^Edpp, Dd^Edp, Cer, Cer, Cer, Re^Edb, Re, Dd, Dd, Dd, Hd, Hd, Dd, Dd^Esd, Dd, Dd, Dd, Dd, Dd, Dd, Dd, Dd, Dd, Dd
Dd, Dd, Hd, Hd, Hd, Hd, Hd, Hd, Hd, Dd^Edp, Dd, Dd^Esd, Dd, Rrd, Rd, Dd^Do, Dd, Dd^Edpp, Dd, Dd, Dd, Dd, Dd, Dd, Dd, Dd, Dd^Vdt, Dd, Hd, Hd, Dd^Do, Dd^Edpp, Dd, Dd^Do, Dd, Dd, Dd, Dd^Edp, Dd^Edb, Rb^Edb, Rb, Rb^Edb, Re^Edb, Re, Dd, Dd, Hd, Dd, Hd, Dd^Edpp, Dd, Dd, Dd, Dd, Dd, Dd^Vdt, Dd, Dd, Hd, Hd, Dd
Dd, Dd, Dd^Edp, Hd, Dd, Hd, Dd, Dd, Dd, Dd, Dd, Dd, Dd, Dd, Rd, Dd, Dd, Dd, Dd, Dd, Dd, Hd, Hd, Dd, Hd, Dd, Dd, Dd, Dd^Esd, Dd^Esd, Dd, Dd, Dd, Dd^Edpp, Hd, Dd, Dd, Dd^Esd, Dd^Esd, Dd^Esd, Re, Re, Dd, Dd^Vdt, Hd, Dd, Hd, Hd, Dd^Ftd, Dd, Dd, Dd, Hd, Dd, Dd, Dd, Dd, Dd, Hd, Hd, Hd
Dd, Dd, Dd, Dd, Dd, Dd, Dd, Dd, Dd, Dd, Dd^Vdt, Dd, Dd, Dd, Cdr, Rd, Dd, Dd, Dd, Dd^Edp, Hd, Dd, Hd, Hd, Hd, Dd, Dd, Dd, Dd, Dd, Dd, Dd, Dd^Esd, Dd^Ftd, Hd, Dd, Hd, Dd^Edp, Dd, Re, Re, Re^Edb, Dd^Esd, Dd, Dd, Hd, Hd, Hd, Dd, Rd, Dd, Dd, Dd, Hd, Hd, Hd, Dd, Dd, Dd, Hd, Hd
Dd, Dd, Dd^Edp, Dd^Esd, Dd, Dd, Dd, Dd, Dd, Dd^Esd, Dd^Esd, Dd, Dd, Dd, Dd, Rrd, Rrd, Dd, Dd^Edp, Dd, Dd^Esd, Dd, Hd, Hd, Dd, Hd, Dd, Dd^Esd, Dd, Dd, Dd^Esd, Dd, Dd, Hd, Hd, Hd, Hd, Dd, Dd, Dd^Edpp, Dd, Dd^Edb, Dd, Dd, Rd, Dd, Rd, Dd, Dd, Dd, Dd, Dd^Edp, Dd, Hd, Hd, Hd, Hd, Dd, Dd, Hd, Dd^Edb
Dd, Dd, Dd, Dd, Dd^Edb, Dd^Edp, Rd, Dd^Esd, Dd, Dd, Dd, Dd, Dd^Edb, Dd, Dd, Dd, Rrd, Dd, Dd, Dd^Esd, Dd, Dd^Edp, Dd, Hd, Dd, Dd, Dd, Dd, Dd, Dd, Dd, Dd, Dd, Dd, Dd, Hd, Dd^Vdt, Dd^Esd, Dd, Dd, Rd, Rd, Rd, Rd, Dd, Rd, Dd, Dd^Esd, Dd, Dd, Dd, Dd^Es, Dd, Hd, Hd, Dd, Dd, Dd, Dd, Dd, Dd
Dd, Dd, Dd, Dd^Edp, Dd^Edb, Dd, Re, Dd, Dd, Dd, Hd, Dd, Hd, Dd^Edb, Dd^Edp, Dd, Dd, Rd, Rd, Dd^Edb, Dd, Dd, Dd, Dd, Dd, Dd, Dd, Dd^Esd, Dd^Edb, Dd^Edb, Dd, Dd, Dd, Dd, Dd, Dd, Dd, Dd, Rd, Dd, Dd, Dd, Dd, Dd^Edp, Dd^Esd, Dd, Dd, Dd, Hd, Dd, Dd^Edp, Dd, Dd, Dd, Dd, Dd^Edp, Dd, Dd^Esd, Dd, Dd^Dc, Dd
Dd, Dd, Dd, Dd, Dd^Edp, Dd^Edb, Cer, Re, Dd^Edpp, Hd, Hd, Hd, Hd, Hd, Hd, Dd, Dd^Edp, Dd, Rd, Dd, Dd, Dd, Dd, Dd^Esd, Cd, Dd, Cd, Cd, Cdr, Dd, Cd, Cdr, Cd, Dd^Dc, Dd^Edp, Dd, Dd, Rd, Dd, Dd, Dd, Dd^Ftd, Dd, Dd, Dd, Dd, Dd, Dd, Hd, Hd, Dd, Dd, Dd, Dd, Dd, Dd, Dd, Dd, Dd, Dd^Esd, Dd
Dd, Dd, Dd^Edb, Rd, Re, 6 Ker, Cer, Rb^Edb, Dd^Edb, Hd, Dd, Dd, Dd, Dd, Dd, Hd, Dd, Dd, Dd, Rrd, Rrd, Cd^Eb, Kd, Cd, Dd, Dd, Rd, Rd, Rd, Rd, Rd, Rd, Rd, Dd, Kd^Ebn, Dd^Edp, Rd, Rd, Dd, Dd, Dd^Edp, Dd, Dd, Dd, Dd, Dd, Dd, Dd, Dd, Hd, Hd, Hd, Dd^Esd, Dd, Dd, Dd^Esd, Dd, Dd, Dd, Hd, Hd
Hd, Hd, Hd, Hd, Hd, Cer, Cer, Rb^Edb, Re, Dd^Edp, Dd, Dd, Hd, Dd^Vdt, Dd, Dd^Edp, Dd, Dd^Dc, Dd, Cd^Ebn, Rd, Rd, Rd, Dd^Esd, Rd, Rd, Dd, Dd, Dd^Vda, Dd, Rd, Rd, Rd^Esd, Rd^Esd, Rd^Esd, Rd, Dd, Dd^Edp, Dd, Dd, Dd^Edp, Dd, Dd, Dd, Dd, Dd, Dd, Dd, Dd, Hd, Hd, Dd, Dd, Dd, Dd, Hd, Dd, Dd, Dd, Hd, Hd
Hd, Hd, Dd, Hd, Dd^Edb, Hd^Edb, Rb^Edb, Rb, Rb^Edb, Dd, Dd, Dd, Hd, Hd, Dd, Dd, Dd, Dd, Cd, Cd, Rd, Rd^Esd, Rd, Dd^Vda, Rd^Esd, Rd^Esd, Rd, Rd, Rd, Rd, Cd^Ftd, Dd, Rd^Esd, Rd^Esd, Rd, Cd, Dd, Hd, Dd, Dd, Dd, Dd, Dd, Dd, Hd, Dd, Hd, Dd, Dd^Edp, Dd^Vdt, Dd, Dd, Dd, Dd, Dd, Hd, Hd, Hd, Dd, Dd, Dd
Dd, Dd, Dd, Dd, Dd, Re^Edb, Dd^Edp, Re^Edb, Dd^Edb, Dd, Dd, Dd, Dd^Edp, Dd^Esd, Dd^Esd, Dd, Dd, Dd, Rd, Rd, Dd, Dd, Rd^Esd, Rd^Esd, Ce, Rd^Esd, Gs^Ft, Ds^Ewsh, Gd^Gvs, Rd, Rd^Esd, Dd, Rd, Dd, Dd, Cdr, Cdr, Hd, Hd, Dd^Edp, Dd, Dd, Dd, Dd, Dd^Edpp, Hd, Hd, Dd^Es, Dd, Dd, Dd, Dd, Dd, Dd, Dd, Hd, Dd^Esd, Hd, Dd, Dd, Dd
Dd, Dd, Dd, Dd, Dd, Dd, Dd, Dd, Dd, Dd, Dd, Dd, Dd^Ftd, Dd, Dd^Esd, Dd, Dd, Cd, Rd^Esd, Rd^Esd, Dd^Vda, Dd, Rd, Rd^Esd, Rd^Esd, 2 Ke, Gs^Ft, Wwt, Gd^Gvs, Rd, Rd, Rd, Rrd, Dd^Vda, Dd, Rd^Esd, Cd, Wwt, Hd, Dd^Ftd, Dd, Dd^Edp, Dd^Esd, Dd, Dd, Hd, Hd, Dd, Dd, Dd, Dd^Edp, Dd^Edp, Rb, Dd, Dd^Edb, Dd, Dd, Hd, Dd, Dd, Dd
Dd, Dd, Dd, Dd, Dd, Dd, Hd, Dd^Vdt, Hd, Dd^Edpp, Hd, Dd, Dd, Dd^Esd, Dd, Dd, Cdr, Cd, Rd, Rd^Esd, Rd, Rd, Rd, Rd, Gs^Edpp, Gs^Ft, Wwt^Ewl, Wwt, Gd^Gvs, Gd^Gvs, Cd, Rd, Rrd, Rd^Esd, Rd, Rd, Kd, Dd, Dd, Dd, Dd, Dd, Dd, Dd, Dd, Dd, Re, Re, Re^Edb, Re^Edb, Cer, Cer, Cer, Dd^Edp, Re^Edb, Dd, Re, Re, Re, Dd, Dd
Dd, Dd^Ftd, Dd, Hd, Hd, Hd, Hd, Hd, Dd^Esd, Hd, Dd, Hd, Dd, Dd, Dd^Esd, Dd, Cd, Rd, Rd, Rd, Rd, Cd^Ftd, Rd^Esd, Rd, Gd^Gvs, Wwt, Wot, Wwt, Gs^Ft, 1 Kd, Cd, Rrd, Rrd, Rd^Esd, Rrd, Rd^Esd, Rd, Cdr, Hd, Dd, Dd, Dd, Dd^Edp, Dd, Dd, Dd^Edb, Dd, Re, Dd^Edb, Re^Edb, Cer, 3 Ker, Cer, Re^Edb, Dd, Re^Edb, Dd, Dd, Dd^Ftd, Dd, Dd
Dd^Edp, Dd, Hd, Hd, Hd, Hd, Hd, Hd, Dd, Dd, Dd, Dd, Dd, Dd, Dd, Dd, Dd, Cd, Rd^Esd, Dd, Dd, Rd^Esd, Rd, Gd^Gvs, Gd^Gvs, Wwt, Wwt, Gs^Ft, Rd, Cd, Rrd, Rrd, Rrd, Rrd, Rd, Rd^Vda, Rd, Cd, Hd, Dd, Dd, Dd, Dd, Dd, Dd, Dd, Dd, Dd^Edp, Dd, Rb, Rb, Cer, Re^Edb, Dd^Edb, Dd, Dd^Esd, Dd^Edb, Dd, Dd^Es, Dd, Dd
Dd^Esd, Dd, Dd, Hd, Dd, Dd, Dd, Dd, Dd, Dd, Dd, Dd, Dd^Esd, Dd, Dd, Dd, Dd, Cdr^Ebn, Rd^Esd, Rd, Dd, Dd^Vda, Rd, Rd, Gd^Gvs, Gd^Gvs, Ds^Ewsh, Gs^Ft, Rd, Rrd, Rrd, Rrd, Rrd, Rrd, Rrd, Rd, Cd, Cdr, Dd, Hd, Dd, Dd, Dd, Dd^Edp, Dd, Dd, Hd, Dd, Dd, Dd, Dd, Dd, Dd^Edb, Dd^Edb, Dd, Dd, Dd^Edb, Dd, Dd, Dd, Dd^Edp
Dd, Dd, Dd, Dd, Dd, Dd, Dd, Dd, Dd, Dd^Vdt, Dd, Dd, Dd, Dd, Dd, Dd, Dd, Dd^Edp, Cd^Ebn, Rd^Esd, Rd, Rd^Esd, Rd, Rd, Rd, Rd^Esd, Rd, Rd^Esd, Rd^Vda, Rd, Rrd, Rrd, Rrd, Rd, Rd^Esd, Rrd, Dd^Edp, Dd, Dd, Dd, Dd, Dd^Esd, Dd, Dd, Dd^Esd, Dd, Dd^Edpp, Hd, Hd, Hd, Dd, Dd, Dd, Dd^Esd, Dd, Hd, Hd, Hd, Dd^Esd, Dd, Dd
Dd, Dd^Esd, Dd, Dd, Dd, Dd, Dd, Dd, Dd, Dd, Hd, Dd, Hd, Dd, Hd, Dd, Dd, Dd, Dd, Cd, Rd, Rd, Dd, Dd, Rd, Rd^Esd, Cd^Ftd, Rd^Esd, Rd, Rd, Rd, Rd, Rd, Rd^Esd, Cd, Kd^Ebn, Dd, Dd, Dd, Dd, Dd, Dd, Dd, Dd, Dd^Es, Dd, Dd^Edp, Hd, Hd, Dd, Dd, Dd^Vdt, Dd, Dd, Dd, Dd, Hd, Hd, Hd, Hd, Dd
Dd, Dd, Hd, Dd, Hd, Dd, Dd, Dd, Dd, Dd, Mdd, Mdd, Hd, Hd, Dd^Edb, Dd, Dd, Dd, Dd, Kd, Cd, Rd, Rd, Dd^Vda, Rd, Dd, Rd, Dd, Rd, Rd, Rd, Rd^Esd, Kd^Eb, Cd, Dd, Dd, Dd^Edp, Dd, Dd, Dd, Hd, Hd, Hd, Dd, Dd, Dd, Dd, Hd, Dd, Hd, Dd, Dd, Dd, Dd, Dd, Dd^Edpp, Hd, Hd, Hd, Hd, Hd
Hd, Dd, Hd, Hd, Dd, Hd, Dd, Dd, Hd, Hd, Hd, Mdd, Hd, Dd, Dd, Dd^Ftd, Dd, Dd^Dc, Dd, Dd, Dd, Cdr, Dd, Rd^Esd, Rd^Esd, Rd, Cdr, Rd, Kdr, Cdr, Cd, Rd, Rd, Dd, Dd, Dd, Dd, Hd, Hd, Hd, Dd, Hd, Hd, Dd, Dd, Dd, Dd, Dd, Dd, Dd, Dd, Dd, Hd, Dd, Dd, Dd, Dd, Dd, Dd^Esd, Hd, Hd
Hd, Hd, Hd, Hd, Dd^Edp, Dd, Dd, Dd, Dd, Hd, Hd, Dd, Dd, Dd, Dd, Dd, Dd, Dd, Dd, Dd, Dd^Edb, Dd, Dd, Cd^Ebn, Dd, Cdr, Dd, Cd, Dd, Dd, Dd, Dd, Dd, Rd, Dd^Edp, Dd, Dd^Esd, Dd, Hd, Hd, Dd^Edp, Hd, Dd, Hd, Dd^Esd, Dd, Dd, Dd, Dd^Ftd, Dd, Dd, Dd, Dd^Dc, Hd, Hd, Dd, Dd, Dd, Dd, Hd, Dd^Esd
Hd, Mdd, Rd, Rd, Dd, Dd^Edp, Dd^Edp, Rd, Dd, Dd, Dd, Dd, Dd, Dd, Dd, Dd, Dd, Dd, Dd, Dd, Dd, Dd, Dd, Dd^Esd, Dd, Dd, Dd, Dd, Dd, Dd, Dd^Edp, Dd, Dd, Rd, Rd, Dd^Edp, Dd^Esd, Dd^Ftd, Dd, Hd, Dd^Dc, Dd^Edp, Dd, Hd, Dd, Dd, Dd, Dd, Dd, Dd, Dd, Dd, Dd, Hd, Hd, Hd, Hd, Dd, Dd, Dd^Esd, Dd
Hd, Hd, Dd, Rd, Dd, Dd^Vdt, Dd, Rd, Rd, Rd, Dd, Dd, Dd, Dd, Dd, Dd^Do, Hd, Hd, Dd, Dd, Dd, Dd, Dd, Dd, Dd, Dd, Dd, Dd^Esd, Dd, Dd^Edb, Dd, Dd, Dd, Dd^Edp, Dd, Rd, Rd, Rd, Rd, Dd, Dd, Dd, Dd, Dd^Esd, Dd, Dd, Dd, Dd, Dd, Dd, Dd, Dd, Dd, Hd, Hd, Hd, Dd, Dd^Esd, Dd, Dd, Dd
Dd, Dd, Dd, Dd, Dd, Dd, Dd, Rd, Rd, Dd, Dd, Dd, Hd, Hd, Mdd, Hd, Hd, Dd, Dd, Dd^Vdt, Dd, Dd^Edp, Dd^Edp, Dd, Dd, Dd, Dd, Dd, Dd, Dd, Dd, Dd, Dd, Dd, Dd^Esd, Dd, Dd^Esd, Dd, Dd^Esd, Rd, Dd, Dd, Dd, Dd^Vdt, Dd, Dd^Esd, Dd, Hd, Dd, Dd, Dd, Dd, Dd, Dd, Hd, Hd, Dd, Dd, Dd, Dd, Dd
Dd, Dd, Dd, Dd, Hd, Dd^Esd, Dd^Edb, Rd, Dd, Rd, Dd, Dd, Hd, Mdd, Mdd, Hd, Dd, Dd, Dd, Dd, Hd, Dd, Dd, Dd, Hd, Dd, Hd, Dd, Dd, Dd, Dd^Vdt, Dd, Dd, Dd, Dd, Dd, Dd, Dd, Dd, Rd, Dd, Dd, Dd, Dd^Esd, Dd, Dd, Hd, Hd, Hd, Dd^Dc, Dd, Dd, Dd, Dd, Dd, Dd, Dd, Dd, Dd, Dd, Dd
Dd, Dd, Dd, Dd, Hd, Hd, Dd, Dd, Dd, Dd, Dd, Hd, Rd, Mdd, Rd, Rd, Dd, Dd^Esd, Dd, Dd, Hd, Dd, Hd, Hd, Mdd, Mdd, Hd, Dd, Dd, Dd, Dd, Dd, Dd, Dd, Dd, Dd, Dd, Dd, Dd, Dd, Dd^Esd, Rd, Rd, Dd, Dd, Dd, Hd, Hd, Dd, Dd, Dd, Dd, Dd, Dd, Dd, Dd, Dd, Dd, Dd, Dd, Dd
Dd, Dd^Edb, Dd, Dd^Edp, Mdd, Hd, Hd, Hd, Dd^Edp, Dd, Dd^Esd, Hd, Dd, Rd, Dd, Rd, Dd^Dr, Dd, Rd, Dd, Hd, Hd, Mdd, Hd, Hd, Hd, Hd, Hd, Dd, Dd, Dd, Dd, Dd, Dd, Dd^Esd, Dd, Dd, Dd, Dd^Vdt, Dd, Dd, Dd, Rd, Dd, Dd, Dd, Dd, Hd, Hd, Dd, Dd, Dd, Dd, Dd^Vdt, Dd^Esd, Dd, Dd, Dd, Dd, Dd, Dd
Dd, Dd, Hd, Hd, Mdd, Hd, Hd, Dd, Dd^Esd, Dd, Dd, Dd, Dd^Vdt, Rd, Dd^Edp, Dd, Dd^Edp, Dd, Rd, Hd, Hd, Mdd, Hd, Hd, Hd, Wwt, Dd, Hd, Hd, Dd, Dd^Ftd, Dd, Dd^Edb, Dd, Rd, Dd, Dd^Do, Dd, Dd^Edb, Dd, Dd, Dd, Dd, Rd, Dd, Dd, Dd^Esd, Hd, Dd, Dd, Dd, Dd, Dd, Dd, Dd, Dd, Dd, Dd, Dd, Hd, Hd
Dd, Dd^Ftd, Hd, Mdd, Hd, Hd, Hd, Dd, Dd, Dd^Esd, Mdd, Dd, Dd, Dd, Hd, Dd^Edb, Hd, Rd, Hd, Hd, Mdd, Mdd, Mdd, Hd, Hd, Wwt, Wwt, Hd, Ds^Ewsh, Dd^Ftd, Dd^Ftd, Dd^Esd, Dd^Edb, Dd^Esd, Cer, Cer, Cer, Rd^Edb, Dd^Edb, Dd, Rd, Rd, Rd, Dd, Dd, Dd, Dd, Dd, Dd, Dd, Dd^Dr, Dd, Dd, Hd, Hd, Hd, Dd, Dd, Dd, Hd, Hd
Hd, Hd, Hd, Mdd, Hd, Hd, Dd, Dd, Mdd, Mdd, Rd, Rd, Dd, Dd, Mdd, Mdd, Mdd, Hd, Mdd, Mdd, Mdd, Mdd, Hd, Hd, Wwt, Hd, Wwt, Wwt, Wwt, Ds^Ewsh, Dd, Dd, Dd^Esd, Rd^Edb, Cer, 5 Ker, Cer, Re^Edb, Rd^Edb, Dd^Edb, Dd, Dd, Dd, Dd, Dd^Esd, Re, Re, Dd^Edp, Dd, Dd, Dd, Dd, Dd, Dd, Hd, Hd, Hd, Dd^Edp, Hd, Hd, Hd
Mdd, Mdd, Mdd, Mdd, Mdd, Hd, Hd, Dd, Mdd, Mdd, Rd, Dd^Esd, Hd, Hd, Hd, Mdd, Dd, Hd, Hd, Hd, Mdd, Mdd, Hd, Wwt, Hd, Wwt, Hd, Wwt, Dd^Ftd, Ds^Ewsh, Dd^Esd, Dd^Vdt, Re, Rb, Re^Edb, Cer, Rb, Rb^Edb, Hd, Dd^Edb, Hd, Hd, Hd, Dd^Edp, Hd, Dd^Esd, Re, Dd, Dd, Dd, Dd, Dd, Dd^Edp, Hd, Dd, Hd, Hd, Hd, Hd, Hd, Hd
Mdd, Mdd, Mdd, Mdd, Mdd, Mdd, Mdd, Mdd, Hd, Rd, Dd^Edpp, Dd^Es, Rd, Dd, Rd, Dd, Rd, Dd, Hd, Hd, Mdd, Mdd, Hd, Hd, Mdd, Hd, Dd, Dd^Ftd, Dd^Ftd, Dd, Dd^Esd, Dd, Rd, Rb, Rd, Re, Re, Hd, Mdd, Mdd, Mdd, Mdd, Mdd, Hd, Dd, Dd, Rd, Dd, Dd, Dd, Hd, Dd, Dd, Dd, Dd, Hd, Hd, Hd, Hd, Hd, Hd
Hd, Mdd, Mdd, Mdd, Mdd, Mdd, Mdd, Mdd, Hd, Rd, Hd, Rd, Rd, Rd, Rd, Rd, Rd, Hd, Hd, Hd, Mdd, Mdd, Mdd, Mdd, Hd, Hd, Hd, Dd^Ftd, Mdd, Dd^Ftd, Dd, Hd, Hd, Dd^Do, Hd, Re, Mdd, Hd, Mdd, Mdd, Dd, Hd, Dd, Hd, Dd^Edp, Dd, Rd, Dd^Vdt, Dd, Dd, Hd, Hd, Hd, Hd, Hd, Dd, Hd, Hd, Hd, Hd, Hd
Hd, Mdd, Hd, Mdd, Mdd, Mdd, Hd, Hd, Hd, Hd, Dd, Dd, Rd, Rd, Rd, Dd, Dd, Hd, Hd, Mdd, Hd, Mdd, Mdd, Mdd, Mdd, Hd, Mdd, Mdd, Mdd, Mdd, Hd, Hd, Hd, Hd, Hd, Hd, Mdd, Mdd, Mdd, Hd, Hd, Dd^Edb, Dd, Dd, Dd, Rd, Dd, Dd, Hd, Hd, Hd, Mdd, Hd, Hd, Hd, Hd, Mdd, Hd, Hd, Hd, Hd
Hd, Hd, Hd, Hd, Mdd, Mdd, Mdd, Mdd, Hd, Hd, Hd, Dd, Dd, Rd, Rd, Dd, Dd, Dd, Hd, Hd, Mdd, Mdd, Mdd, Mdd, Mdd, Mdd, Mdd, Mdd, Mdd, Mdd, Mdd, Hd, Hd, Hd, Hd, Mdd, Mdd, Mdd, Hd, Hd, Dd, Dd, Dd, Dd, Dd^Ftd, Dd, Dd, Hd, Hd, Hd, Mdd, Mdd, Mdd, Hd, Mdd, Hd, Mdd, Mdd, Mdd, Hd, Mdd
Dd, Hd, Hd, Hd, Mdd, Mdd, Hd, Hd, Dd, Hd, Dd, Hd, Dd, Dd, Rd, Rd, Dd, Hd, Hd, Hd, Mdd, Mdd, Dd, Mdd, Mdd, Mdd, Mdd, Mdd, Mdd, Mdd, Dd, Hd, Dd, Hd, Hd, Hd, Hd, Hd, Dd, Dd, Dd, Dd^Edb, Dd, Dd, Dd^Ftd, Dd^Dc, Dd^Esd, Dd^Dc, Hd, Mdd, Mdd, Mdd, Dd, Mdd, Hd, Mdd, Hd, Mdd, Hd, Mdd, Dd
